12 12 12 12 12 12 12 12 12 12 12 12 12 12 12 12 12 12 12 12 12 12 12 12 12 12 12 12 12 12 12 12 12 12 12 12 12 12 12 12 12 12 12 12 12 12 12 12 12 12 12 12 12 12 12 12 12 12 12 12 12 12 12 12 12 12 12 12 12 12 12 12 12 12 12 12 12 12 12 12 12 12 12 12 12 12 12 12 12 12 12 12 12 12 12 12 12 12 12 12
12 58 61 61 61 61 61 61 61 61 61 61 61 61 61 61 61 61 61 61 61 61 61 61 61 61 61 61 61 61 61 61 61 61 61 61 61 61 61 61 61 61 61 61 61 61 61 61 61 61 61 61 61 61 61 61 61 61 61 61 61 61 61 61 61 61 61 61 61 61 61 61 61 61 61 61 61 61 61 61 61 61 61 61 61 61 61 61 61 61 61 61 61 61 61 61 61 61 61 61
12 65 10 49 49 49 49 49 49 10 10 49 49 49 49 49 49 49 49 49 49 49 49 49 49 49 49 49 49 49 49 49 49 49 49 49 49 49 49 49 49 49 49 49 49 49 49 49 49 49 49 49 49 49 49 49 49 49 49 49 49 49 49 49 49 49 49 49 49 49 49 49 49 49 49 49 49 49 49 49 49 49 49 49 49 49 49 49 49 49 49 49 49 49 49 49 49 49 49 49
12 65 53 11 11 11 11 11 11 52 53 0 1 0 1 0 1 0 1 0 4 4 4 4 4 4 4 4 4 4 1 0 1 0 1 0 1 0 1 0 1 0 1 0 1 0 1 0 1 0 1 0 1 0 1 0 1 0 1 0 1 0 1 0 1 0 1 0 1 0 1 0 1 0 1 0 1 0 1 0 1 0 1 0 1 0 1 0 1 0 1 0 1 0 1 0 1 0 1 0
12 65 53 11 26 30 30 29 11 52 53 1 0 1 0 1 0 1 0 0 4 1 0 1 0 1 0 1 0 4 1 0 1 0 1 0 1 0 1 0 1 0 1 0 1 0 1 0 1 0 1 0 1 0 1 11 11 11 11 11 11 11 11 11 11 11 11 11 11 11 11 11 11 11 11 11 11 11 11 11 11 11 11 11 11 0 1 0 1 0 1 0 1 0 1 0 1 0 1 0
12 65 53 11 24 9 9 27 11 52 53 0 1 0 1 0 1 0 1 1 4 0 26 30 30 30 30 29 1 4 0 1 0 1 0 1 0 1 0 1 0 1 0 1 0 1 0 1 0 1 0 1 0 1 0 11 11 11 11 11 11 11 11 11 11 11 11 11 11 11 11 11 11 11 11 11 11 11 11 11 11 11 11 11 11 1 0 1 0 1 0 1 0 1 0 1 0 1 0 1
12 65 53 11 24 9 9 27 11 52 53 1 0 1 0 1 0 1 0 0 4 1 24 9 9 9 9 27 0 4 1 0 1 0 1 0 1 0 1 0 1 0 1 0 1 0 1 0 1 0 1 0 1 0 1 11 11 11 11 11 11 11 11 11 11 11 11 11 11 11 11 11 11 11 11 11 11 11 11 11 11 11 11 11 11 0 1 0 1 0 1 0 1 0 1 0 1 0 1 0
12 65 53 11 25 21 44 28 11 52 53 1 0 1 0 1 0 1 0 1 4 0 24 9 9 9 9 27 1 4 1 0 1 0 1 0 19 18 18 18 18 18 20 0 1 0 1 0 1 0 1 0 1 0 1 11 11 11 11 11 11 11 0 1 0 1 0 1 0 1 11 11 11 11 11 11 11 11 11 11 11 11 11 11 11 1 0 1 0 1 0 1 0 1 0 1 0 1 0 1 0
12 65 53 11 11 11 39 11 11 50 51 0 1 0 1 0 1 0 1 0 4 1 24 9 9 9 9 27 0 4 0 1 0 1 0 1 16 12 12 12 12 12 17 1 0 1 0 1 0 1 0 1 0 1 0 11 11 11 11 11 11 11 1 0 1 0 1 0 1 0 11 11 11 11 11 0 1 0 1 0 1 0 11 11 11 0 1 0 1 0 1 0 1 0 1 0 1 0 1 0
12 65 53 0 1 0 39 0 1 0 1 0 1 0 1 0 1 0 1 0 4 0 25 21 44 21 21 28 1 4 1 0 1 0 1 0 16 12 12 12 12 12 17 0 1 0 1 0 1 0 1 0 1 0 1 11 11 11 11 11 11 11 0 1 0 7 0 1 0 1 11 11 11 11 11 1 0 1 0 1 0 1 11 11 11 0 1 0 1 0 1 0 1 0 1 0 1 0 1 0
12 65 53 1 0 1 39 1 0 1 0 1 0 1 0 1 0 1 0 1 4 4 4 4 39 4 4 4 4 4 0 1 0 1 0 1 16 12 12 12 12 12 17 1 0 1 0 1 0 1 0 1 0 1 0 11 11 11 11 11 11 11 1 0 1 41 38 38 38 38 38 38 38 38 38 38 38 38 40 0 1 0 11 11 11 11 0 1 0 1 0 1 0 1 0 1 0 1 0 1
12 65 53 0 1 0 39 0 1 0 1 0 1 0 1 0 1 0 1 0 0 1 0 1 39 1 0 1 0 1 1 0 1 0 1 0 16 12 12 12 12 12 17 0 1 0 1 0 1 0 1 0 1 0 1 11 11 11 11 11 11 11 0 1 0 39 0 1 0 1 11 11 11 11 11 1 0 1 39 1 0 1 11 11 11 11 1 0 1 0 1 0 1 0 1 0 1 0 1 0
12 65 53 1 0 1 39 1 0 1 0 1 0 1 0 1 0 1 0 1 0 1 0 1 39 0 1 0 1 0 1 0 1 0 1 0 14 13 13 13 13 13 15 1 0 1 0 1 0 1 0 1 0 1 0 11 11 11 11 11 11 11 1 0 1 39 1 0 1 0 11 11 11 11 11 0 1 0 39 0 1 0 11 11 11 11 0 1 0 1 0 1 0 1 0 1 0 1 0 1 0
12 65 53 0 1 0 43 40 1 0 1 0 1 0 1 0 1 0 1 0 1 0 1 0 39 1 0 1 0 1 0 1 0 1 0 1 0 1 0 1 0 1 0 1 0 1 0 1 0 1 0 1 0 1 0 11 11 11 11 11 11 11 0 1 0 39 0 1 0 1 11 11 11 11 11 1 0 1 39 1 0 1 11 11 11 11 1 0 1 0 1 0 1 0 1 0 1 0 1 0 1
12 65 53 1 0 55 56 39 0 1 0 1 0 1 0 1 0 1 0 1 0 1 0 1 39 0 1 0 1 0 1 0 1 0 1 0 1 0 1 0 1 0 1 0 1 0 1 0 1 0 1 0 1 0 1 11 11 11 11 11 11 11 11 11 11 39 11 11 11 11 11 11 11 11 11 11 11 11 39 11 11 11 11 11 11 11 0 1 0 1 0 1 0 1 0 1 0 1 0 1 0
12 65 53 0 55 10 53 43 40 0 1 0 1 0 1 0 1 0 1 0 1 0 1 0 39 1 0 1 0 1 0 1 0 1 0 1 0 1 0 1 0 1 0 1 0 1 0 1 0 1 0 1 0 1 0 11 11 11 11 11 11 11 11 11 11 39 11 11 11 11 11 11 11 11 11 11 11 11 39 11 11 11 11 11 11 11 1 0 1 0 1 0 1 0 1 0 1 0 1 0 1
12 65 53 1 50 10 10 53 3 38 38 38 38 38 38 38 38 38 38 38 38 38 38 38 2 38 38 38 38 38 38 38 38 38 38 38 38 38 38 38 40 11 11 1 0 1 0 1 0 1 0 1 0 1 0 11 11 11 11 11 11 11 11 11 11 39 11 11 11 11 11 11 11 11 11 11 11 11 39 11 11 11 11 11 11 11 0 1 0 1 0 1 0 1 0 1 0 1 0 1 0
12 65 53 0 1 50 49 51 39 0 1 0 1 0 1 0 1 0 1 0 1 0 11 0 1 0 1 0 1 0 1 0 11 0 1 0 1 0 1 0 39 1 11 1 0 1 0 1 0 1 0 1 0 1 0 11 11 11 11 11 11 11 11 11 11 39 11 11 11 11 11 11 11 11 11 11 11 11 39 11 11 11 11 11 11 11 1 0 1 0 1 0 1 0 1 0 1 0 1 0
12 65 53 1 0 1 0 41 42 1 0 1 0 1 0 1 0 1 0 1 0 1 0 1 0 1 0 1 0 1 0 11 0 1 0 1 0 1 0 1 39 1 0 48 0 1 0 1 0 1 0 1 0 1 0 11 11 11 11 11 11 11 11 11 11 39 11 11 11 11 11 11 11 11 11 11 11 11 39 11 11 11 11 11 11 11 0 1 0 1 0 1 0 1 0 1 0 1 0 1
12 65 53 0 1 0 1 39 1 0 1 0 1 0 1 0 1 0 1 0 1 0 1 0 1 0 1 0 1 0 1 0 1 0 1 0 1 0 1 0 39 0 1 0 1 0 1 0 1 0 1 0 1 0 1 11 11 11 11 11 11 11 11 11 11 39 11 11 11 11 11 11 11 11 11 11 11 11 39 11 11 11 11 11 11 11 1 0 1 0 1 0 1 0 1 0 1 0 1 0 1
12 65 53 1 0 1 0 39 0 1 0 1 0 1 0 1 0 1 0 1 0 1 0 1 0 1 0 1 0 1 0 1 0 1 0 1 0 1 0 1 39 1 0 1 0 1 0 1 0 1 0 1 0 1 0 11 11 11 11 11 11 11 11 11 11 39 11 11 19 18 18 18 18 18 20 11 11 11 39 11 11 11 11 11 11 11 0 1 0 1 0 1 0 1 0 1 0 1 0 1 0
12 65 53 0 1 0 1 39 1 0 1 0 1 0 1 0 1 0 11 0 1 0 1 0 1 0 1 0 1 0 1 0 1 0 1 0 1 0 1 0 39 0 1 0 1 0 1 0 1 0 1 0 1 0 1 11 11 11 11 11 11 11 11 11 11 39 11 11 16 12 12 12 12 12 17 11 11 11 39 11 11 11 11 11 11 11 1 0 1 0 1 0 1 0 1 0 1 0 1 0 1
12 65 53 1 0 1 0 39 0 1 0 1 0 11 0 1 0 1 0 1 0 1 0 1 0 1 0 1 0 1 0 1 0 1 0 1 0 1 0 1 39 1 0 1 0 1 0 1 0 1 0 1 0 1 0 11 11 11 11 11 11 11 11 11 11 39 11 11 16 12 12 12 12 12 17 11 11 11 39 11 11 11 11 11 11 11 0 1 0 1 0 1 0 1 0 1 0 1 0 1 0
12 65 53 0 1 0 1 39 1 0 1 0 1 0 1 0 1 0 1 0 1 0 1 0 1 0 1 0 1 11 1 0 1 0 1 0 1 0 1 0 39 0 1 0 1 0 1 0 1 0 1 0 1 0 1 11 11 11 11 11 11 11 11 11 11 39 11 11 16 12 12 12 12 12 17 11 11 11 39 11 11 11 11 11 11 11 1 0 1 0 1 0 1 0 1 0 1 0 1 0 1
12 65 53 1 0 1 0 39 0 1 0 1 0 1 0 1 0 1 0 1 0 1 0 1 0 1 0 1 0 1 0 1 0 1 0 1 0 11 0 1 39 1 0 1 0 1 0 1 0 1 0 1 0 1 0 11 11 11 11 11 11 11 11 11 11 39 11 11 16 12 12 12 12 12 17 11 11 11 39 11 11 11 11 11 11 11 0 1 0 1 0 1 0 1 0 1 0 1 0 1 0
12 65 53 0 1 26 30 47 30 29 1 0 1 0 1 0 1 0 1 0 1 0 11 0 1 0 1 0 1 0 1 0 1 0 1 0 1 0 1 0 39 0 1 0 1 0 1 0 1 0 1 0 1 0 1 11 11 11 11 11 11 11 11 11 11 39 11 11 14 13 13 13 13 13 15 11 11 11 39 11 11 11 11 11 11 11 1 0 1 0 1 0 1 0 1 0 1 0 1 0 1
12 65 53 1 0 24 9 9 9 27 0 1 0 1 0 1 0 1 0 1 0 1 0 1 0 1 0 1 0 11 0 1 0 1 0 1 0 1 0 1 39 1 0 1 0 1 0 1 0 1 0 1 0 1 0 11 11 11 11 11 11 11 11 11 11 39 11 11 1 0 1 7 1 0 1 11 11 11 39 11 11 11 11 11 11 11 0 1 0 1 0 1 0 1 0 1 0 1 0 1 0
12 65 53 0 1 24 9 9 9 27 1 0 1 0 1 0 1 0 1 0 1 0 1 0 1 0 1 0 1 0 1 0 1 0 11 0 1 0 1 0 39 0 1 0 1 0 1 0 1 0 1 0 1 0 1 11 11 11 11 11 11 11 11 11 11 39 11 11 11 1 0 1 0 1 11 11 11 11 39 11 11 11 11 11 11 11 1 0 1 0 1 0 1 0 1 0 1 0 1 0 1
12 65 53 1 0 25 21 44 21 28 0 1 0 1 0 1 0 1 0 11 0 1 0 1 0 1 0 1 0 1 0 1 0 1 0 1 0 1 0 1 39 1 0 1 0 1 0 1 0 1 0 1 0 1 0 11 11 11 11 11 11 11 11 11 11 39 11 11 11 11 1 39 1 11 11 11 11 11 39 11 11 11 11 11 11 11 0 1 0 1 0 1 0 1 0 1 0 1 0 1 0
12 65 53 0 1 0 1 39 1 0 1 0 1 0 1 0 1 11 1 0 1 0 1 0 1 0 1 0 1 0 1 0 1 0 1 0 1 0 1 0 39 0 1 0 1 0 1 0 1 0 1 0 1 0 1 11 11 11 11 11 11 11 11 11 11 39 11 11 11 11 11 39 11 11 11 11 11 11 39 11 11 11 11 11 11 11 1 0 1 0 1 0 1 0 1 0 1 0 1 0 1
12 65 53 1 0 1 0 39 0 1 0 1 0 1 0 1 0 1 0 1 0 1 0 1 0 1 0 1 0 11 0 1 0 1 0 1 0 1 0 1 39 1 0 1 0 1 0 1 0 1 0 1 0 1 0 11 11 11 11 11 11 11 11 11 11 39 11 11 11 11 11 39 11 11 11 11 11 11 39 11 11 11 11 11 11 11 0 1 0 1 0 1 0 1 0 1 0 1 0 1 0
12 65 53 0 1 0 1 43 40 0 1 0 1 0 1 0 1 0 1 0 1 0 1 0 11 0 1 0 1 0 1 0 1 0 1 0 1 0 1 0 43 40 1 0 1 0 1 0 1 0 1 0 1 0 1 11 11 11 11 11 11 11 11 11 11 39 11 11 11 11 11 39 11 11 11 11 11 11 39 11 11 11 11 11 11 11 1 0 1 0 1 0 1 0 1 0 1 0 1 0 1
12 65 53 1 0 1 0 1 43 40 0 1 0 1 0 1 11 11 0 1 0 1 0 1 0 1 0 1 0 1 0 1 0 1 0 1 0 1 0 1 0 43 40 1 0 1 0 1 0 1 0 1 0 1 0 11 11 11 11 11 11 11 11 11 11 39 11 11 11 11 11 39 11 11 11 11 11 11 39 11 11 11 11 11 11 11 0 1 0 1 0 1 0 1 0 1 0 1 0 1 0
12 65 53 0 1 0 1 0 1 43 40 0 1 0 1 0 1 0 1 0 1 0 1 0 1 0 1 0 1 0 1 0 1 0 11 11 1 0 1 0 1 0 43 40 1 0 1 0 1 0 1 0 1 0 1 11 11 11 11 11 11 11 11 11 11 39 11 11 11 11 11 39 11 11 11 11 11 11 39 11 11 11 11 11 11 11 1 0 1 0 1 0 1 0 1 0 1 0 1 0 1
12 65 53 1 0 1 0 1 0 1 43 40 0 1 0 1 0 1 0 1 0 1 0 1 0 1 0 1 0 1 0 1 0 1 0 1 0 1 0 1 0 1 0 43 40 1 0 1 0 1 0 1 0 1 0 11 11 11 11 11 11 11 11 11 11 39 11 11 11 11 11 39 11 11 11 11 11 11 39 11 11 11 11 11 11 11 0 1 0 1 0 1 0 1 0 1 0 1 0 1 0
12 65 53 0 1 0 1 0 1 0 1 43 40 0 1 0 1 0 1 0 1 0 1 0 1 0 1 0 1 0 1 0 1 0 1 0 1 0 1 0 1 0 1 0 43 40 1 0 1 0 1 0 1 0 1 11 11 11 11 11 11 11 11 11 11 39 11 11 11 11 11 39 11 11 11 11 11 11 39 11 11 11 11 11 11 11 1 0 1 0 1 0 1 0 1 0 1 0 1 0 1
12 65 53 1 0 1 0 1 0 1 0 1 39 1 0 1 0 1 0 1 0 1 0 1 0 1 0 1 0 1 0 1 0 1 0 1 0 1 0 1 0 1 0 1 0 43 40 1 0 1 0 1 0 1 0 11 11 11 11 11 11 11 11 11 11 43 38 38 38 30 30 47 30 30 38 38 38 38 42 11 11 11 11 11 11 11 0 1 0 1 0 1 0 1 0 1 0 1 0 1 0 1
12 65 53 0 1 0 1 0 1 0 1 0 39 0 1 0 1 0 1 0 1 0 1 0 1 0 1 0 1 0 1 0 1 0 1 0 1 0 1 0 1 0 1 0 1 0 43 40 1 0 1 0 1 0 1 11 11 11 11 11 11 11 11 11 11 11 11 11 11 25 22 9 23 28 11 11 11 11 11 11 11 11 11 11 11 11 1 0 1 0 1 0 1 0 1 0 1 0 1 0 1 0
12 65 53 1 0 1 0 1 0 1 0 1 39 1 0 1 0 1 0 1 0 1 0 1 11 1 0 1 0 1 0 1 0 1 0 1 0 1 0 1 0 1 0 1 0 1 0 43 40 1 0 1 0 1 0 11 11 11 11 11 11 11 11 11 11 11 11 11 11 1 25 44 28 1 11 11 11 11 11 11 11 11 11 11 11 11 0 1 0 1 0 1 0 1 0 1 0 1 0 1 0 1
12 65 53 0 1 0 1 0 1 0 1 0 39 0 1 0 1 0 1 0 1 0 1 0 1 0 1 0 1 0 1 0 1 0 11 0 1 0 1 0 1 0 1 0 1 0 1 0 43 40 1 0 1 0 1 11 11 11 11 11 11 11 11 11 11 11 11 11 11 0 1 39 1 0 11 11 11 11 11 11 11 11 11 11 11 11 1 0 1 0 1 0 1 0 1 0 1 0 1 0 1 0
12 65 53 1 0 1 0 1 0 1 0 11 39 11 0 1 0 1 0 1 0 1 0 1 0 1 0 1 0 1 0 1 0 1 0 1 0 1 0 1 0 1 0 1 0 1 0 1 0 43 40 1 0 1 0 11 11 11 11 11 11 11 11 11 11 11 11 11 11 1 0 39 0 1 11 11 11 11 11 11 11 11 11 11 11 11 0 1 0 1 0 1 0 1 0 1 0 1 0 1 0 1
12 65 4 4 4 4 4 4 4 4 4 4 39 4 4 4 4 4 4 4 4 4 4 4 4 0 1 0 1 0 1 0 1 0 1 0 1 0 11 0 1 0 1 0 1 0 1 0 1 0 43 40 1 0 1 11 11 11 11 11 11 11 11 11 11 11 11 11 11 11 11 39 11 11 11 11 11 11 11 11 11 11 11 11 11 11 1 0 1 0 1 0 1 0 1 0 1 0 1 0 1 0
12 65 53 1 0 1 0 1 0 1 0 1 39 1 0 1 0 1 0 1 0 1 0 1 4 1 0 1 0 1 0 1 0 1 0 1 0 1 0 1 0 1 0 11 0 1 0 1 0 1 0 43 40 1 0 11 11 11 11 11 11 11 11 11 11 11 11 11 11 11 11 39 11 11 11 11 11 11 11 11 11 11 11 11 11 11 0 1 0 1 0 1 0 1 0 1 0 1 0 1 0 1
12 65 10 56 1 0 1 0 1 0 1 0 39 0 1 0 1 0 1 0 1 0 1 0 4 0 1 0 1 0 1 0 1 11 1 0 1 0 1 0 1 0 1 0 1 0 1 0 1 0 1 0 43 38 38 38 38 38 38 38 38 38 38 38 38 38 38 38 38 38 38 2 38 38 38 38 38 38 38 38 38 38 38 38 38 38 1 0 1 0 1 0 1 0 1 0 1 0 1 0 1 0
12 60 68 10 56 1 0 1 0 1 0 1 39 1 0 1 0 1 0 1 0 1 0 1 4 1 0 1 0 11 0 1 0 1 0 1 0 1 0 1 0 1 0 1 0 1 0 1 0 1 0 1 0 1 0 11 11 11 11 11 11 11 11 11 11 11 11 11 11 11 11 11 11 11 11 11 11 11 11 11 11 11 11 11 11 11 0 1 0 1 0 1 0 1 0 1 0 1 0 1 0 1
12 12 60 68 10 56 1 0 1 0 1 0 39 0 1 0 1 0 1 0 1 0 1 0 4 0 1 0 1 0 1 0 1 0 1 0 1 0 1 0 1 0 1 0 1 0 1 0 1 0 11 0 1 0 1 11 11 11 11 11 11 11 11 11 11 11 11 11 11 11 11 11 11 11 11 11 11 11 11 11 11 11 11 11 11 11 1 0 1 0 1 0 1 0 1 0 1 0 1 0 1 0
12 12 12 60 68 10 56 1 0 1 0 1 39 1 0 1 0 1 0 1 0 1 0 1 4 1 0 1 0 1 0 1 0 1 0 1 0 1 0 1 0 11 0 1 0 1 0 1 0 1 0 1 0 1 0 11 11 11 11 11 11 11 11 11 11 11 11 11 11 11 11 11 11 11 11 11 11 11 11 11 11 11 11 11 11 11 0 1 0 1 0 1 0 1 0 1 0 1 0 1 0 1
12 12 12 12 60 68 10 54 54 56 1 0 39 0 1 0 1 0 1 0 1 0 1 0 4 0 1 0 1 0 1 0 1 0 1 0 1 0 1 0 1 0 1 0 1 0 1 0 1 0 1 0 1 0 1 11 11 11 11 11 11 11 11 11 11 11 11 11 11 11 11 11 11 11 11 11 11 11 11 11 11 11 11 11 11 11 1 0 1 0 1 0 1 0 1 0 1 0 1 0 1 0
12 12 12 12 12 60 66 66 68 51 0 1 39 1 0 1 0 1 0 1 0 1 0 1 4 1 0 1 0 1 0 1 0 1 0 1 0 11 0 1 0 1 0 1 0 1 0 1 0 1 0 1 0 1 0 11 11 11 11 11 11 11 11 11 11 11 11 11 11 11 11 11 11 11 11 11 11 11 11 11 11 11 11 11 11 11 0 1 0 1 0 1 0 1 0 1 0 1 0 1 0 1
12 12 12 12 12 12 8 8 8 38 38 38 2 38 38 38 38 38 38 38 38 38 38 38 38 38 38 38 38 40 1 0 1 0 1 0 1 0 1 0 1 0 11 11 1 0 1 0 1 0 1 0 1 0 1 11 11 11 11 11 11 11 11 11 11 11 11 11 11 11 11 11 11 11 11 11 11 11 11 11 11 11 11 11 11 11 1 0 1 0 1 0 1 0 1 0 1 0 1 0 1 0
12 12 12 12 12 58 61 61 63 56 0 1 0 1 0 1 0 1 0 1 0 1 0 1 4 1 0 1 0 39 0 1 0 1 0 1 0 1 0 1 0 1 0 1 0 1 0 1 0 11 0 1 0 1 0 11 11 11 11 11 11 11 11 11 11 11 11 11 11 11 11 11 11 11 11 11 11 11 11 11 11 11 11 11 11 11 0 1 0 1 0 1 0 1 0 1 0 1 0 1 0 1
12 12 12 12 58 63 10 49 49 51 1 0 1 0 1 0 1 0 1 0 1 0 1 0 4 0 1 0 1 39 1 0 1 0 1 0 1 0 1 0 1 0 1 0 1 0 11 0 1 0 1 0 1 0 1 11 11 11 11 11 11 11 11 11 11 11 11 11 11 11 11 11 11 11 11 11 11 11 11 11 11 11 11 11 11 11 1 0 1 0 1 0 1 0 1 0 1 0 1 0 1 0
12 12 12 58 63 10 51 1 0 1 0 1 0 1 0 1 0 1 0 1 0 1 0 1 4 1 0 1 0 39 0 1 0 1 0 1 0 1 0 1 0 1 11 1 0 1 0 1 0 1 0 1 0 1 0 1 11 11 11 11 11 11 11 11 11 11 11 11 11 11 11 11 11 11 11 11 11 11 11 11 11 11 11 11 11 11 11 0 1 0 1 0 1 0 1 0 1 0 1 0 1 0
12 12 58 63 10 51 1 0 1 0 1 0 1 0 1 0 1 0 1 0 1 0 1 0 4 0 1 0 1 39 1 0 1 0 1 0 1 0 11 0 1 0 1 0 1 0 1 0 1 0 1 0 1 0 1 0 1 11 11 11 11 11 11 11 11 11 11 11 11 11 11 11 11 11 11 11 11 11 11 11 11 11 11 11 11 11 11 1 0 1 0 1 0 1 0 1 0 1 0 1 0 1
12 58 63 10 51 1 0 1 0 1 0 1 0 1 0 1 0 1 0 1 0 1 0 1 4 1 0 1 0 39 0 1 0 11 0 1 0 1 0 1 0 1 0 1 0 1 0 1 0 1 0 1 0 1 0 1 0 1 11 11 11 11 11 11 11 11 11 11 11 11 11 11 11 11 11 11 11 11 11 11 11 11 11 11 11 11 11 0 1 0 1 0 1 0 1 0 1 0 1 0 1 0
12 65 10 51 1 0 1 0 1 0 1 0 1 0 1 0 1 0 1 0 1 0 1 0 4 0 1 0 1 39 1 0 1 0 1 0 1 0 1 0 1 0 1 0 1 0 1 0 1 0 11 0 1 0 1 0 1 0 1 11 11 11 11 11 11 11 11 11 11 11 11 11 11 11 11 11 11 11 11 11 11 11 11 11 11 11 11 1 0 1 0 1 0 1 0 1 0 1 0 1 0 1
12 65 53 1 0 1 0 1 0 1 0 1 0 1 0 1 0 1 0 1 0 1 0 1 4 1 0 1 0 39 0 1 0 1 0 1 0 1 0 1 0 1 0 1 0 1 0 1 0 1 0 1 0 1 0 1 0 11 0 1 11 11 11 11 11 11 11 11 11 11 11 11 11 11 11 11 11 11 11 11 11 11 11 11 11 11 11 0 1 0 1 0 1 0 1 0 1 0 1 0 1 0
12 65 4 4 4 4 4 4 4 4 4 4 4 4 4 4 4 4 4 4 4 4 4 4 4 0 1 0 1 39 1 0 1 0 1 0 1 0 1 0 1 0 1 0 1 0 1 0 1 0 1 0 1 0 1 0 1 0 1 0 11 11 11 11 11 11 11 11 11 11 11 11 11 11 11 11 11 11 11 11 11 11 11 11 11 11 11 1 0 1 0 1 0 1 0 1 0 1 0 1 0 1 0
12 65 53 1 0 1 0 1 0 1 0 1 0 1 0 1 0 1 0 1 0 1 0 1 0 1 0 1 0 39 0 1 0 1 0 1 0 1 0 1 0 1 0 1 0 1 0 1 0 1 0 1 0 1 0 1 0 1 0 1 0 11 11 11 11 11 11 11 11 11 11 11 11 11 11 11 11 11 11 11 11 11 11 11 11 11 11 0 1 0 1 0 1 0 1 0 1 0 1 0 1 0
12 65 53 0 1 0 1 0 1 0 1 0 1 0 1 0 1 0 1 0 1 0 1 0 1 0 1 0 1 39 1 0 1 0 1 0 1 0 1 0 1 0 1 0 1 0 1 0 1 0 1 0 1 0 1 0 1 0 1 0 1 0 11 11 11 11 11 11 11 11 11 11 11 11 11 11 11 11 11 11 11 11 11 11 11 11 11 1 0 1 0 1 0 1 0 1 0 1 0 1 0 1
12 65 53 1 0 1 0 1 0 1 0 1 0 1 0 1 0 1 0 1 0 1 0 1 0 1 0 1 0 39 0 1 0 1 0 1 0 1 0 1 0 1 0 1 0 1 0 1 0 1 0 1 0 1 0 1 0 1 0 1 0 1 0 1 0 1 0 1 0 1 0 1 0 1 0 1 0 1 0 1 0 1 0 1 0 1 0 1 0 1 0 1 0 1 0 1 0 1 0 1
12 65 53 0 1 0 1 0 1 0 1 0 1 0 1 0 1 0 1 0 1 0 1 0 1 0 1 0 1 39 1 0 1 0 1 0 1 0 1 0 1 0 1 0 1 0 1 0 1 0 1 0 1 0 1 0 1 0 1 0 1 0 1 0 1 0 1 0 1 0 1 0 1 0 1 0 1 0 1 0 1 0 1 0 1 0 1 0 1 0 1 0 1 0 1 0 1 0 1 0
12 65 53 1 0 1 0 1 0 1 0 1 0 1 0 1 0 1 0 1 0 1 0 1 0 1 0 1 0 39 0 1 0 1 0 1 0 1 0 1 0 1 0 1 0 1 0 1 0 1 0 1 0 1 0 1 0 1 0 1 0 1 0 1 0 1 0 1 0 1 0 1 0 1 0 1 0 1 0 1 0 1 0 1 0 1 0 1 0 1 0 1 0 1 0 1 0 1 0 1
12 65 53 0 1 0 1 0 1 0 1 0 1 0 1 0 1 0 1 0 1 0 1 0 1 0 1 0 1 39 1 0 1 0 1 0 1 0 1 0 1 0 1 0 1 0 1 0 1 0 1 0 1 0 1 0 1 0 1 0 1 0 1 0 1 0 1 0 1 0 1 0 1 0 1 0 1 0 1 0 1 0 1 0 1 0 1 0 1 0 1 0 1 0 1 0 1 0 1 0
12 65 53 1 0 1 0 1 0 1 0 1 0 1 0 1 0 1 0 1 0 1 0 1 0 1 0 1 0 39 0 1 0 1 0 1 0 1 0 1 0 1 0 1 0 1 0 1 0 1 0 1 0 1 0 1 0 1 0 1 0 1 0 1 0 1 0 1 0 1 0 1 0 1 0 1 0 1 0 1 0 1 0 1 0 1 0 1 0 1 0 1 0 1 0 1 0 1 0 1
12 65 53 0 1 0 1 0 1 0 1 0 1 0 1 0 1 0 1 0 1 0 1 0 1 0 1 0 1 39 1 0 1 0 1 0 1 0 1 0 1 0 1 0 1 0 1 0 1 0 1 0 1 0 1 0 1 0 1 0 1 0 1 0 1 0 1 0 1 0 1 0 1 0 1 0 1 0 1 0 1 0 1 0 1 0 1 0 1 0 1 0 1 0 1 0 1 0 1 0
12 65 53 1 0 1 0 1 0 1 0 1 0 1 0 1 0 1 0 1 0 1 0 1 0 1 0 1 0 39 0 1 0 1 0 1 0 1 0 1 0 1 0 1 0 1 0 1 0 1 0 1 0 1 0 1 0 1 0 1 0 1 0 1 0 1 0 1 0 1 0 1 0 1 0 1 0 1 0 1 0 1 0 1 0 1 0 1 0 1 0 1 0 1 0 1 0 1 0 1
12 65 53 0 1 0 1 0 1 0 1 0 1 0 1 0 1 0 1 0 1 0 1 0 1 0 1 0 1 39 1 0 1 0 1 0 1 0 1 0 1 0 1 0 1 0 1 0 1 0 1 0 1 0 1 0 1 0 1 0 1 0 1 0 1 0 1 0 1 0 1 0 1 0 1 0 1 0 1 0 1 0 1 0 1 0 1 0 1 0 1 0 1 0 1 0 1 0 1 0
12 65 53 1 0 1 0 1 0 1 0 1 0 1 0 1 0 1 0 1 0 1 0 1 0 1 0 1 0 39 0 1 0 1 0 1 0 1 0 1 0 1 0 1 0 1 0 1 0 1 0 1 0 1 0 1 0 1 0 1 0 1 0 1 0 1 0 1 0 1 0 1 0 1 0 1 0 1 0 1 0 1 0 1 0 1 0 1 0 1 0 1 0 1 0 1 0 1 0 1
12 65 53 0 1 0 1 0 1 0 1 0 1 0 1 0 1 0 1 0 1 0 1 0 1 0 1 26 30 47 30 29 1 0 1 0 1 0 1 0 1 0 1 0 1 0 1 0 1 0 1 0 1 0 1 0 1 0 1 0 1 0 1 0 1 0 1 0 1 0 1 0 1 0 1 0 1 0 1 0 1 0 1 0 1 0 1 0 1 0 1 0 1 0 1 0 1 0 1 0
12 65 53 1 0 1 0 1 0 1 0 1 0 1 0 1 0 1 0 1 0 1 0 1 0 1 0 24 9 9 9 27 0 1 0 1 0 1 0 1 0 1 0 1 0 1 0 1 0 1 0 1 0 1 0 1 0 1 0 1 0 1 0 1 0 1 0 1 0 1 0 1 0 1 0 1 0 1 0 1 0 1 0 1 0 1 0 1 0 1 0 1 0 1 0 1 0 1 0 1
12 65 53 0 1 0 1 0 1 0 1 0 1 0 1 0 1 0 1 0 1 0 1 0 1 0 1 25 21 21 21 28 1 0 1 0 1 0 1 0 1 0 1 0 1 0 1 0 1 0 1 0 1 0 1 0 1 0 1 0 1 0 1 0 1 0 1 0 1 0 1 0 1 0 1 0 1 0 1 0 1 0 1 0 1 0 1 0 1 0 1 0 1 0 1 0 1 0 1 0
12 65 53 1 0 1 0 1 0 1 0 1 0 1 0 1 0 1 0 1 0 1 0 1 0 1 0 1 0 1 0 1 0 1 0 1 0 1 0 1 0 1 0 1 0 1 0 1 0 1 0 1 0 1 0 1 0 1 0 1 0 1 0 1 0 1 0 1 0 1 0 1 0 1 0 1 0 1 0 1 0 1 0 1 0 1 0 1 0 1 0 1 0 1 0 1 0 1 0 1
12 65 53 0 1 0 1 0 1 0 1 0 1 0 1 0 1 0 1 0 1 0 1 0 1 0 1 0 1 0 1 0 1 0 1 0 1 0 1 0 1 0 1 0 1 0 1 0 1 0 1 0 1 0 1 0 1 0 1 0 1 0 1 0 1 0 1 0 1 0 1 0 1 0 1 0 1 0 1 0 1 0 1 0 1 0 1 0 1 0 1 0 1 0 1 0 1 0 1 0
12 65 53 1 0 1 0 1 0 1 0 1 0 1 0 1 0 1 0 1 0 1 0 1 0 1 0 1 0 1 0 1 0 1 0 1 0 1 0 1 0 1 0 1 0 1 0 1 0 1 0 1 0 1 0 1 0 1 0 1 0 1 0 1 0 1 0 1 0 1 0 1 0 1 0 1 0 1 0 1 0 1 0 1 0 1 0 1 0 1 0 1 0 1 0 1 0 1 0 1
12 65 53 0 1 0 1 0 1 0 1 0 1 0 1 0 1 0 1 0 1 0 1 0 1 0 1 0 1 0 1 0 1 0 1 0 1 0 1 0 1 0 1 0 1 0 1 0 1 0 1 0 1 0 1 0 1 0 1 0 1 0 1 0 1 0 1 0 1 0 1 0 1 0 1 0 1 0 1 0 1 0 1 0 1 0 1 0 1 0 1 0 1 0 1 0 1 0 1 0
12 65 53 1 0 1 0 1 0 1 0 1 0 1 0 1 0 1 0 1 0 1 0 1 0 1 0 1 0 1 0 1 0 1 0 1 0 1 0 1 0 1 0 1 0 1 0 1 0 1 0 1 0 1 0 1 0 1 0 1 0 1 0 1 0 1 0 1 0 1 0 1 0 1 0 1 0 1 0 1 0 1 0 1 0 1 0 1 0 1 0 1 0 1 0 1 0 1 0 1
12 65 53 0 1 0 1 0 1 0 1 0 1 0 1 0 1 0 1 0 1 0 1 0 1 0 1 0 1 0 1 0 1 0 1 0 1 0 1 0 1 0 1 0 1 0 1 0 1 0 1 0 1 0 1 0 1 0 1 0 1 0 1 0 1 0 1 0 1 0 1 0 1 0 1 0 1 0 1 0 1 0 1 0 1 0 1 0 1 0 1 0 1 0 1 0 1 0 1 0
12 65 53 1 0 1 0 1 0 1 0 1 0 1 0 1 0 1 0 1 0 1 0 1 0 1 0 1 0 1 0 1 0 1 0 1 0 1 0 1 0 1 0 1 0 1 0 1 0 1 0 1 0 1 0 1 0 1 0 1 0 1 0 1 0 1 0 1 0 1 0 1 0 1 0 1 0 1 0 1 0 1 0 1 0 1 0 1 0 1 0 1 0 1 0 1 0 1 0 1
12 65 53 0 1 0 1 0 1 0 1 0 1 0 1 0 1 0 1 0 1 0 1 0 1 0 1 0 1 0 1 0 1 0 1 0 1 0 1 0 1 0 1 0 1 0 1 0 1 0 1 0 1 0 1 0 1 0 1 0 1 0 1 0 1 0 1 0 1 0 1 0 1 0 1 0 1 0 1 0 1 0 1 0 1 0 1 0 1 0 1 0 1 0 1 0 1 0 1 0
12 65 53 1 0 1 0 1 0 1 0 1 0 1 0 1 0 1 0 1 0 1 0 1 0 1 0 1 0 1 0 1 0 1 0 1 0 1 0 1 0 1 0 1 0 1 0 1 0 1 0 1 0 1 0 1 0 1 0 1 0 1 0 1 0 1 0 1 0 1 0 1 0 1 0 1 0 1 0 1 0 1 0 1 0 1 0 1 0 1 0 1 0 1 0 1 0 1 0 1
12 65 53 0 1 0 1 0 1 0 1 0 1 0 1 0 1 0 1 0 1 0 1 0 1 0 1 0 1 0 1 0 1 0 1 0 1 0 1 0 1 0 1 0 1 0 1 0 1 0 1 0 1 0 1 0 1 0 1 0 1 0 1 0 1 0 1 0 1 0 1 0 1 0 1 0 1 0 1 0 1 0 1 0 1 0 1 0 1 0 1 0 1 0 1 0 1 0 1 0
12 65 53 1 0 1 0 1 0 1 0 1 0 1 0 1 0 1 0 1 0 1 0 1 0 1 0 1 0 1 0 1 0 1 0 1 0 1 0 1 0 1 0 1 0 1 0 1 0 1 0 1 0 1 0 1 0 1 0 1 0 1 0 1 0 1 0 1 0 1 0 1 0 1 0 1 0 1 0 1 0 1 0 1 0 1 0 1 0 1 0 1 0 1 0 1 0 1 0 1
12 65 53 0 1 0 1 0 1 0 1 0 1 0 1 0 1 0 1 0 1 0 1 0 1 0 1 0 1 0 1 0 1 0 1 0 1 0 1 0 1 0 1 0 1 0 1 0 1 0 1 0 1 0 1 0 1 0 1 0 1 0 1 0 1 0 1 0 1 0 1 0 1 0 1 0 1 0 1 0 1 0 1 0 1 0 1 0 1 0 1 0 1 0 1 0 1 0 1 0
12 65 53 1 0 1 0 1 0 1 0 1 0 1 0 1 0 1 0 1 0 1 0 1 0 1 0 1 0 1 0 1 0 1 0 1 0 1 0 1 0 1 0 1 0 1 0 1 0 1 0 1 0 1 0 1 0 1 0 1 0 1 0 1 0 1 0 1 0 1 0 1 0 1 0 1 0 1 0 1 0 1 0 1 0 1 0 1 0 1 0 1 0 1 0 1 0 1 0 1
12 65 53 0 1 0 1 0 1 0 1 0 1 0 1 0 1 0 1 0 1 0 1 0 1 0 1 0 1 0 1 0 1 0 1 0 1 0 1 0 1 0 1 0 1 0 1 0 1 0 1 0 1 0 1 0 1 0 1 0 1 0 1 0 1 0 1 0 1 0 1 0 1 0 1 0 1 0 1 0 1 0 1 0 1 0 1 0 1 0 1 0 1 0 1 0 1 0 1 0
12 65 53 1 0 1 0 1 0 1 0 1 0 1 0 1 0 1 0 1 0 1 0 1 0 1 0 1 0 1 0 1 0 1 0 1 0 1 0 1 0 1 0 1 0 1 0 1 0 1 0 1 0 1 0 1 0 1 0 1 0 1 0 1 0 1 0 1 0 1 0 1 0 1 0 1 0 1 0 1 0 1 0 1 0 1 0 1 0 1 0 1 0 1 0 1 0 1 0 1
12 65 53 0 1 0 1 0 1 0 1 0 1 0 1 0 1 0 1 0 1 0 1 0 1 0 1 0 1 0 1 0 1 0 1 0 1 0 1 0 1 0 1 0 1 0 1 0 1 0 1 0 1 0 1 0 1 0 1 0 1 0 1 0 1 0 1 0 1 0 1 0 1 0 1 0 1 0 1 0 1 0 1 0 1 0 1 0 1 0 1 0 1 0 1 0 1 0 1 0
12 65 53 1 0 1 0 1 0 1 0 1 0 1 0 1 0 1 0 1 0 1 0 1 0 1 0 1 0 1 0 1 0 1 0 1 0 1 0 1 0 1 0 1 0 1 0 1 0 1 0 1 0 1 0 1 0 1 0 1 0 1 0 1 0 1 0 1 0 1 0 1 0 1 0 1 0 1 0 1 0 1 0 1 0 1 0 1 0 1 0 1 0 1 0 1 0 1 0 1
12 65 53 0 1 0 1 0 1 0 1 0 1 0 1 0 1 0 1 0 1 0 1 0 1 0 1 0 1 0 1 0 1 0 1 0 1 0 1 0 1 0 1 0 1 0 1 0 1 0 1 0 1 0 1 0 1 0 1 0 1 0 1 0 1 0 1 0 1 0 1 0 1 0 1 0 1 0 1 0 1 0 1 0 1 0 1 0 1 0 1 0 1 0 1 0 1 0 1 0
12 65 53 1 0 1 0 1 0 1 0 1 0 1 0 1 0 1 0 1 0 1 0 1 0 1 0 1 0 1 0 1 0 1 0 1 0 1 0 1 0 1 0 1 0 1 0 1 0 1 0 1 0 1 0 1 0 1 0 1 0 1 0 1 0 1 0 1 0 1 0 1 0 1 0 1 0 1 0 1 0 1 0 1 0 1 0 1 0 1 0 1 0 1 0 1 0 1 0 1
12 65 53 0 1 0 1 0 1 0 1 0 1 0 1 0 1 0 1 0 1 0 1 0 1 0 1 0 1 0 1 0 1 0 1 0 1 0 1 0 1 0 1 0 1 0 1 0 1 0 1 0 1 0 1 0 1 0 1 0 1 0 1 0 1 0 1 0 1 0 1 0 1 0 1 0 1 0 1 0 1 0 1 0 1 0 1 0 1 0 1 0 1 0 1 0 1 0 1 0
12 65 53 1 0 1 0 1 0 1 0 1 0 1 0 1 0 1 0 1 0 1 0 1 0 1 0 1 0 1 0 1 0 1 0 1 0 1 0 1 0 1 0 1 0 1 0 1 0 1 0 1 0 1 0 1 0 1 0 1 0 1 0 1 0 1 0 1 0 1 0 1 0 1 0 1 0 1 0 1 0 1 0 1 0 1 0 1 0 1 0 1 0 1 0 1 0 1 0 1
12 65 53 0 1 0 1 0 1 0 1 0 1 0 1 0 1 0 1 0 1 0 1 0 1 0 1 0 1 0 1 0 1 0 1 0 1 0 1 0 1 0 1 0 1 0 1 0 1 0 1 0 1 0 1 0 1 0 1 0 1 0 1 0 1 0 1 0 1 0 1 0 1 0 1 0 1 0 1 0 1 0 1 0 1 0 1 0 1 0 1 0 1 0 1 0 1 0 1 0
12 65 53 1 0 1 0 1 0 1 0 1 0 1 0 1 0 1 0 1 0 1 0 1 0 1 0 1 0 1 0 1 0 1 0 1 0 1 0 1 0 1 0 1 0 1 0 1 0 1 0 1 0 1 0 1 0 1 0 1 0 1 0 1 0 1 0 1 0 1 0 1 0 1 0 1 0 1 0 1 0 1 0 1 0 1 0 1 0 1 0 1 0 1 0 1 0 1 0 1
12 65 53 0 1 0 1 0 1 0 1 0 1 0 1 0 1 0 1 0 1 0 1 0 1 0 1 0 1 0 1 0 1 0 1 0 1 0 1 0 1 0 1 0 1 0 1 0 1 0 1 0 1 0 1 0 1 0 1 0 1 0 1 0 1 0 1 0 1 0 1 0 1 0 1 0 1 0 1 0 1 0 1 0 1 0 1 0 1 0 1 0 1 0 1 0 1 0 1 0
12 65 53 1 0 1 0 1 0 1 0 1 0 1 0 1 0 1 0 1 0 1 0 1 0 1 0 1 0 1 0 1 0 1 0 1 0 1 0 1 0 1 0 1 0 1 0 1 0 1 0 1 0 1 0 1 0 1 0 1 0 1 0 1 0 1 0 1 0 1 0 1 0 1 0 1 0 1 0 1 0 1 0 1 0 1 0 1 0 1 0 1 0 1 0 1 0 1 0 1
12 65 10 54 54 54 54 54 54 54 54 54 54 54 54 54 54 54 54 54 54 54 54 54 54 54 54 54 54 54 54 54 54 54 54 54 54 54 54 54 54 54 54 54 54 54 54 54 54 54 54 54 54 54 54 54 54 54 54 54 54 54 54 54 54 54 54 54 54 54 54 54 54 54 54 54 54 54 54 54 54 54 54 54 54 54 54 54 54 54 54 54 54 54 54 54 54 54 54 54
12 60 61 61 61 61 61 61 61 61 61 61 61 61 61 61 61 61 61 61 61 61 61 61 61 61 61 61 61 61 61 61 61 61 61 61 61 61 61 61 61 61 61 61 61 61 61 61 61 61 61 61 61 61 61 61 61 61 61 61 61 61 61 61 61 61 61 61 61 61 61 61 61 61 61 61 61 61 61 61 61 61 61 61 61 61 61 61 61 61 61 61 61 61 61 61 61 61 61 61
12 12 12 12 12 12 12 12 12 12 12 12 12 12 12 12 12 12 12 12 12 12 12 12 12 12 12 12 12 12 12 12 12 12 12 12 12 12 12 12 12 12 12 12 12 12 12 12 12 12 12 12 12 12 12 12 12 12 12 12 12 12 12 12 12 12 12 12 12 12 12 12 12 12 12 12 12 12 12 12 12 12 12 12 12 12 12 12 12 12 12 12 12 12 12 12 12 12 12 12