8 8 8 8 8 8 8 8 8 8 8 8 8 8 8 8 8 8 8 8 8 8 8 8 8 8 8 8 8 8 8 8 8 8 8 8 8 8 8 8 8 8 8 8 8 8 8 8 8 8 8 8 8 8 8 8 8 8 8 8 8 8 8 8 8 8 8 8 8 8 8 8 8 8 8 8 8 8 8 8 8 8 8 8 8 8 8 8 8 8 8 8 8 8 8 8 8 8 8 8
8 7 7 7 7 7 7 7 7 7 7 7 7 7 7 7 7 7 7 7 7 7 7 7 7 7 7 7 7 7 7 7 7 7 7 7 7 7 7 7 7 7 7 7 7 7 7 7 7 7 7 7 7 7 7 7 7 7 7 7 7 7 7 7 7 7 7 7 7 7 7 7 7 7 7 7 7 7 7 7 7 7 7 7 7 7 7 7 7 7 7 7 7 7 7 7 7 7 7 7
8 7 10 10 10 10 10 10 10 10 10 10 10 10 10 10 10 10 10 10 10 10 10 10 10 10 10 10 10 10 10 10 10 10 10 10 10 10 10 10 10 10 10 10 10 10 10 10 10 10 10 10 10 10 10 10 10 10 10 10 10 10 10 10 10 10 10 10 10 10 10 10 10 10 10 10 10 10 10 10 10 10 10 10 10 10 10 10 10 10 10 10 10 10 10 10 10 10 10 10
8 7 10 11 11 11 11 11 11 10 10 0 1 0 1 0 1 0 1 0 6 4 4 4 4 4 4 4 4 6 1 0 1 0 1 0 1 0 1 0 1 0 1 0 1 0 1 0 1 0 1 0 1 0 1 0 1 0 1 0 1 0 1 0 1 0 1 0 1 0 1 0 1 0 1 0 1 0 1 0 1 0 1 0 1 0 1 0 1 0 1 0 1 0 1 0 1 0 1 0
8 7 10 11 31 30 30 32 11 10 10 1 0 1 0 1 0 1 0 2 5 3 3 3 3 3 3 3 3 5 1 0 1 0 1 0 1 0 1 0 1 0 1 0 1 0 1 0 1 0 1 0 1 0 1 11 11 11 11 11 11 11 11 11 11 11 11 11 11 11 11 11 11 11 11 11 11 11 11 11 11 11 11 11 11 0 1 0 1 0 1 0 1 0 1 0 1 0 1 0
8 7 10 11 24 9 9 27 11 10 10 0 1 0 1 0 1 0 1 2 5 0 1 0 1 0 1 0 2 5 0 1 0 1 0 1 0 1 0 1 0 1 0 1 0 1 0 1 0 1 0 1 0 1 0 11 11 11 11 11 11 11 11 11 11 11 11 11 11 11 11 11 11 11 11 11 11 11 11 11 11 11 11 11 11 1 0 1 0 1 0 1 0 1 0 1 0 1 0 1
8 7 10 11 24 9 9 27 11 10 10 1 0 1 0 1 0 1 0 2 5 1 0 9 9 9 9 1 2 5 1 0 1 0 1 0 1 0 1 0 1 0 1 0 1 0 1 0 1 0 1 0 1 0 1 11 11 11 11 11 11 11 11 11 11 11 11 11 11 11 11 11 11 11 11 11 11 11 11 11 11 11 11 11 11 0 1 0 1 0 1 0 1 0 1 0 1 0 1 0
8 7 10 11 22 25 28 23 11 10 0 1 0 1 0 1 0 1 0 2 5 0 1 9 9 9 9 0 2 5 1 0 1 0 1 0 19 18 18 18 18 18 20 0 1 0 1 0 1 0 1 0 1 0 1 11 11 11 11 11 11 11 0 1 0 1 0 1 0 1 11 11 11 11 11 11 11 11 11 11 11 11 11 11 11 1 0 1 0 1 0 1 0 1 0 1 0 1 0 1 0
8 7 10 11 11 24 27 11 11 10 1 0 1 0 1 0 1 0 1 2 5 1 0 9 9 9 9 1 2 5 0 1 0 1 0 1 16 12 12 12 12 12 17 1 0 1 0 1 0 1 0 1 0 1 0 11 11 11 11 11 11 11 1 0 1 0 1 0 1 0 11 11 11 11 11 0 1 0 1 0 1 0 11 11 11 0 1 0 1 0 1 0 1 0 1 0 1 0 1 0
8 7 10 0 1 24 27 0 1 0 1 0 1 0 1 0 1 0 1 2 6 0 1 9 9 9 9 0 2 6 1 0 1 0 1 0 16 12 12 12 12 12 17 0 1 0 1 0 1 0 1 0 1 0 1 11 11 11 11 11 11 11 0 1 0 1 0 1 0 1 11 11 11 11 11 1 0 1 0 1 0 1 11 11 11 0 1 0 1 0 1 0 1 0 1 0 1 0 1 0
8 7 10 1 0 24 27 1 0 1 0 1 0 1 0 1 0 1 0 2 6 6 6 6 9 9 6 6 6 6 0 1 0 1 0 1 16 12 12 12 12 12 17 1 0 1 0 1 0 1 0 1 0 1 0 11 11 11 11 11 11 11 1 0 1 9 9 9 9 9 9 9 9 9 9 9 9 9 9 0 1 0 11 11 11 11 0 1 0 1 0 1 0 1 0 1 0 1 0 1
8 7 10 0 1 24 27 0 1 0 1 0 1 0 1 0 1 0 1 0 3 3 3 3 9 9 3 3 3 3 1 0 1 0 1 0 16 12 12 12 12 12 17 0 1 0 1 0 1 0 1 0 1 0 1 11 11 11 11 11 11 11 0 1 0 9 0 1 0 1 11 11 11 11 11 1 0 1 9 1 0 1 11 11 11 11 1 0 1 0 1 0 1 0 1 0 1 0 1 0
8 7 10 1 0 24 29 30 32 1 0 1 0 1 0 1 0 1 0 1 0 1 0 1 9 9 1 0 1 0 1 0 1 0 1 0 14 13 13 13 13 13 15 1 0 1 0 1 0 1 0 1 0 1 0 11 11 11 11 11 11 11 1 0 1 9 1 0 1 0 11 11 11 11 11 0 1 0 9 0 1 0 11 11 11 11 0 1 0 1 0 1 0 1 0 1 0 1 0 1 0
8 7 10 0 1 37 33 9 27 0 1 0 1 0 1 0 1 0 1 0 1 0 1 0 9 9 0 1 0 1 0 1 0 1 0 1 0 1 0 1 0 1 0 1 0 1 0 1 0 1 0 1 0 1 0 11 11 11 11 11 11 11 0 1 0 9 0 1 0 1 11 11 11 11 11 1 0 1 9 1 0 1 11 11 11 11 1 0 1 0 1 0 1 0 1 0 1 0 1 0 1
8 7 10 1 0 10 10 9 29 32 0 1 0 1 0 1 0 1 0 1 0 1 0 1 9 9 1 0 1 0 1 0 1 0 1 0 1 0 1 0 1 0 1 0 1 0 1 0 1 0 1 0 1 0 1 11 11 11 11 11 11 11 11 11 11 9 11 11 11 11 11 11 11 11 11 11 11 11 9 11 11 11 11 11 11 11 0 1 0 1 0 1 0 1 0 1 0 1 0 1 0
8 7 10 0 10 10 10 9 9 29 1 0 1 0 1 0 1 0 1 0 1 0 1 0 9 9 0 1 0 1 0 1 0 1 0 1 0 1 0 1 0 1 0 1 0 1 0 1 0 1 0 1 0 1 0 11 11 11 11 11 11 11 11 11 11 9 11 11 11 11 11 11 11 11 11 11 11 11 9 11 11 11 11 11 11 11 1 0 1 0 1 0 1 0 1 0 1 0 1 0 1
8 7 10 1 0 10 10 10 9 9 9 9 9 9 9 9 9 9 9 9 9 9 9 9 9 9 9 9 9 9 9 9 9 9 9 9 9 9 9 9 9 11 11 1 0 1 0 1 0 1 0 1 0 1 0 11 11 11 11 11 11 11 11 11 11 9 11 11 11 11 11 11 11 11 11 11 11 11 9 11 11 11 11 11 11 11 0 1 0 1 0 1 0 1 0 1 0 1 0 1 0
8 7 10 0 1 0 10 9 9 0 1 0 1 0 1 0 1 0 1 0 1 0 11 0 1 0 1 0 1 0 1 0 11 0 1 0 1 0 1 0 9 1 11 1 0 1 0 1 0 1 0 1 0 1 0 11 11 11 11 11 11 11 11 11 11 9 11 11 11 11 11 11 11 11 11 11 11 11 9 11 11 11 11 11 11 11 1 0 1 0 1 0 1 0 1 0 1 0 1 0
8 7 10 1 0 1 0 9 0 1 0 1 0 1 0 1 0 1 0 1 0 1 0 1 0 1 0 1 0 1 0 11 0 1 0 1 0 1 0 1 9 1 0 10 0 1 0 1 0 1 0 1 0 1 0 11 11 11 11 11 11 11 11 11 11 9 11 11 11 11 11 11 11 11 11 11 11 11 9 11 11 11 11 11 11 11 0 1 0 1 0 1 0 1 0 1 0 1 0 1
8 7 10 0 1 0 1 9 1 0 1 0 1 0 1 0 1 0 1 0 1 0 1 0 1 0 1 0 1 0 1 0 1 0 1 0 1 0 1 0 9 0 1 0 1 0 1 0 1 0 1 0 1 0 1 11 11 11 11 11 11 11 11 11 11 9 11 11 11 11 11 11 11 11 11 11 11 11 9 11 11 11 11 11 11 11 1 0 1 0 1 0 1 0 1 0 1 0 1 0 1
8 7 10 1 0 1 0 9 0 1 0 1 0 1 0 1 0 1 0 1 0 1 0 1 0 1 0 1 0 1 0 1 0 1 0 1 0 1 0 1 9 1 0 1 0 1 0 1 0 1 0 1 0 1 0 11 11 11 11 11 11 11 11 11 11 9 11 11 19 18 18 18 18 18 20 11 11 11 9 11 11 11 11 11 11 11 0 1 0 1 0 1 0 1 0 1 0 1 0 1 0
8 7 10 0 1 0 1 9 1 0 1 0 1 0 1 0 1 0 11 0 1 0 1 0 1 0 1 0 1 0 1 0 1 0 1 0 1 0 1 0 9 0 1 0 1 0 1 0 1 0 1 0 1 0 1 11 11 11 11 11 11 11 11 11 11 9 11 11 16 12 12 12 12 12 17 11 11 11 9 11 11 11 11 11 11 11 1 0 1 0 1 0 1 0 1 0 1 0 1 0 1
8 7 10 1 0 1 0 9 0 1 0 1 0 11 0 1 0 1 0 1 0 1 0 1 0 1 0 1 0 1 0 1 0 1 0 1 0 1 0 1 9 1 0 1 0 1 0 1 0 1 0 1 0 1 0 11 11 11 11 11 11 11 11 11 11 9 11 11 16 12 12 12 12 12 17 11 11 11 9 11 11 11 11 11 11 11 0 1 0 1 0 1 0 1 0 1 0 1 0 1 0
8 7 10 0 1 0 1 9 1 0 1 0 1 0 1 0 1 0 1 0 1 0 1 0 1 0 1 0 1 11 1 0 1 0 1 0 1 0 1 0 9 0 1 0 1 0 1 0 1 0 1 0 1 0 1 11 11 11 11 11 11 11 11 11 11 9 11 11 16 12 12 12 12 12 17 11 11 11 9 11 11 11 11 11 11 11 1 0 1 0 1 0 1 0 1 0 1 0 1 0 1
8 7 10 1 0 1 0 9 0 1 0 1 0 1 0 1 0 1 0 1 0 1 0 1 0 1 0 1 0 1 0 1 0 1 0 1 0 11 0 1 9 1 0 1 0 1 0 1 0 1 0 1 0 1 0 11 11 11 11 11 11 11 11 11 11 9 11 11 16 12 12 12 12 12 17 11 11 11 9 11 11 11 11 11 11 11 0 1 0 1 0 1 0 1 0 1 0 1 0 1 0
8 7 10 0 1 9 9 9 9 9 1 0 1 0 1 0 1 0 1 0 1 0 11 0 1 0 1 0 1 0 1 0 1 0 1 0 1 0 1 0 9 0 1 0 1 0 1 0 1 0 1 0 1 0 1 11 11 11 11 11 11 11 11 11 11 9 11 11 14 13 13 13 13 13 15 11 11 11 9 11 11 11 11 11 11 11 1 0 1 0 1 0 1 0 1 0 1 0 1 0 1
8 7 10 1 0 9 9 9 9 9 0 1 0 1 0 1 0 1 0 1 0 1 0 1 0 1 0 1 0 11 0 1 0 1 0 1 0 1 0 1 9 1 0 1 0 1 0 1 0 1 0 1 0 1 0 11 11 11 11 11 11 11 11 11 11 9 11 11 1 0 1 0 1 0 1 11 11 11 9 11 11 11 11 11 11 11 0 1 0 1 0 1 0 1 0 1 0 1 0 1 0
8 7 10 0 1 9 9 9 9 9 1 0 1 0 1 0 1 0 1 0 1 0 1 0 1 0 1 0 1 0 1 0 1 0 11 0 1 0 1 0 9 0 1 0 1 0 1 0 1 0 1 0 1 0 1 11 11 11 11 11 11 11 11 11 11 9 11 11 11 1 0 1 0 1 11 11 11 11 9 11 11 11 11 11 11 11 1 0 1 0 1 0 1 0 1 0 1 0 1 0 1
8 7 10 1 0 9 9 9 9 9 0 1 0 1 0 1 0 1 0 11 0 1 0 1 0 1 0 1 0 1 0 1 0 1 0 1 0 1 0 1 9 1 0 1 0 1 0 1 0 1 0 1 0 1 0 11 11 11 11 11 11 11 11 11 11 9 11 11 11 11 1 9 1 11 11 11 11 11 9 11 11 11 11 11 11 11 0 1 0 1 0 1 0 1 0 1 0 1 0 1 0
8 7 10 0 1 0 1 9 1 0 1 0 1 0 1 0 1 11 1 0 1 0 1 0 1 0 1 0 1 0 1 0 1 0 1 0 1 0 1 0 9 0 1 0 1 0 1 0 1 0 1 0 1 0 1 11 11 11 11 11 11 11 11 11 11 9 11 11 11 11 11 9 11 11 11 11 11 11 9 11 11 11 11 11 11 11 1 0 1 0 1 0 1 0 1 0 1 0 1 0 1
8 7 10 1 0 1 0 9 0 1 0 1 0 1 0 1 0 1 0 1 0 1 0 1 0 1 0 1 0 11 0 1 0 1 0 1 0 1 0 1 9 1 0 1 0 1 0 1 0 1 0 1 0 1 0 11 11 11 11 11 11 11 11 11 11 9 11 11 11 11 11 9 11 11 11 11 11 11 9 11 11 11 11 11 11 11 0 1 0 1 0 1 0 1 0 1 0 1 0 1 0
8 7 10 0 1 0 1 9 9 0 1 0 1 0 1 0 1 0 1 0 1 0 1 0 11 0 1 0 1 0 1 0 1 0 1 0 1 0 1 0 9 9 1 0 1 0 1 0 1 0 1 0 1 0 1 11 11 11 11 11 11 11 11 11 11 9 11 11 11 11 11 9 11 11 11 11 11 11 9 11 11 11 11 11 11 11 1 0 1 0 1 0 1 0 1 0 1 0 1 0 1
8 7 10 1 0 1 0 1 9 9 0 1 0 1 0 1 11 11 0 1 0 1 0 1 0 1 0 1 0 1 0 1 0 1 0 1 0 1 0 1 0 9 9 1 0 1 0 1 0 1 0 1 0 1 0 11 11 11 11 11 11 11 11 11 11 9 11 11 11 11 11 9 11 11 11 11 11 11 9 11 11 11 11 11 11 11 0 1 0 1 0 1 0 1 0 1 0 1 0 1 0
8 7 10 0 1 0 1 0 1 9 9 0 1 0 1 0 1 0 1 0 1 0 1 0 1 0 1 0 1 0 1 0 1 0 11 11 1 0 1 0 1 0 9 9 1 0 1 0 1 0 1 0 1 0 1 11 11 11 11 11 11 11 11 11 11 9 11 11 11 11 11 9 11 11 11 11 11 11 9 11 11 11 11 11 11 11 1 0 1 0 1 0 1 0 1 0 1 0 1 0 1
8 7 10 1 0 1 0 1 0 1 9 9 0 1 0 1 0 1 0 1 0 1 0 1 0 1 0 1 0 1 0 1 0 1 0 1 0 1 0 1 0 1 0 9 9 1 0 1 0 1 0 1 0 1 0 11 11 11 11 11 11 11 11 11 11 9 11 11 11 11 11 9 11 11 11 11 11 11 9 11 11 11 11 11 11 11 0 1 0 1 0 1 0 1 0 1 0 1 0 1 0
8 7 10 0 1 0 1 0 1 0 1 9 9 0 1 0 1 0 1 0 1 0 1 0 1 0 1 0 1 0 1 0 1 0 1 0 1 0 1 0 1 0 1 0 9 9 1 0 1 0 1 0 1 0 1 11 11 11 11 11 11 11 11 11 11 9 11 11 11 11 11 9 11 11 11 11 11 11 9 11 11 11 11 11 11 11 1 0 1 0 1 0 1 0 1 0 1 0 1 0 1
8 7 10 1 0 1 0 1 0 1 0 1 9 1 0 1 0 1 0 1 0 1 0 1 0 1 0 1 0 1 0 1 0 1 0 1 0 1 0 1 0 1 0 1 0 9 9 1 0 1 0 1 0 1 0 11 11 11 11 11 11 11 11 11 11 9 9 9 9 9 9 9 9 9 9 9 9 9 9 11 11 11 11 11 11 11 0 1 0 1 0 1 0 1 0 1 0 1 0 1 0 1
8 7 10 0 1 0 1 0 1 0 1 0 9 0 1 0 1 0 1 0 1 0 1 0 1 0 1 0 1 0 1 0 1 0 1 0 1 0 1 0 1 0 1 0 1 0 9 9 1 0 1 0 1 0 1 11 11 11 11 11 11 11 11 11 11 11 11 11 11 9 9 9 9 9 11 11 11 11 11 11 11 11 11 11 11 11 1 0 1 0 1 0 1 0 1 0 1 0 1 0 1 0
8 7 10 1 0 1 0 1 0 1 0 1 9 1 0 1 0 1 0 1 0 1 0 1 11 1 0 1 0 1 0 1 0 1 0 1 0 1 0 1 0 1 0 1 0 1 0 9 9 1 0 1 0 1 0 11 11 11 11 11 11 11 11 11 11 11 11 11 11 1 9 9 9 1 11 11 11 11 11 11 11 11 11 11 11 11 0 1 0 1 0 1 0 1 0 1 0 1 0 1 0 1
8 7 10 0 1 0 1 0 1 0 1 0 9 0 1 0 1 0 1 0 1 0 1 0 1 0 1 0 1 0 1 0 1 0 11 0 1 0 1 0 1 0 1 0 1 0 1 0 9 9 1 0 1 0 1 11 11 11 11 11 11 11 11 11 11 11 11 11 11 0 1 9 1 0 11 11 11 11 11 11 11 11 11 11 11 11 1 0 1 0 1 0 1 0 1 0 1 0 1 0 1 0
8 7 10 1 0 1 0 1 0 1 0 11 9 11 0 1 0 1 0 1 0 1 0 1 0 1 0 1 0 1 0 1 0 1 0 1 0 1 0 1 0 1 0 1 0 1 0 1 0 9 9 1 0 1 0 11 11 11 11 11 11 11 11 11 11 11 11 11 11 1 0 9 0 1 11 11 11 11 11 11 11 11 11 11 11 11 0 1 0 1 0 1 0 1 0 1 0 1 0 1 0 1
8 7 10 6 4 4 4 4 4 4 4 6 9 6 4 4 4 4 4 4 4 4 4 4 6 0 1 0 1 0 1 0 1 0 1 0 1 0 11 0 1 0 1 0 1 0 1 0 1 0 9 9 1 0 1 11 11 11 11 11 11 11 11 11 11 11 11 11 11 11 11 9 11 11 11 11 11 11 11 11 11 11 11 11 11 11 1 0 1 0 1 0 1 0 1 0 1 0 1 0 1 0
8 7 10 3 3 3 3 3 3 3 3 3 9 3 3 3 3 3 3 3 3 3 3 3 5 1 0 1 0 1 0 1 0 1 0 1 0 1 0 1 0 1 0 11 0 1 0 1 0 1 0 9 9 1 0 11 11 11 11 11 11 11 11 11 11 11 11 11 11 11 11 9 11 11 11 11 11 11 11 11 11 11 11 11 11 11 0 1 0 1 0 1 0 1 0 1 0 1 0 1 0 1
8 7 10 0 1 0 1 0 1 0 1 0 9 0 1 0 1 0 1 0 1 0 1 2 5 0 1 0 1 0 1 0 1 11 1 0 1 0 1 0 1 0 1 0 1 0 1 0 1 0 1 0 9 9 9 9 9 9 9 9 9 9 9 9 9 9 9 9 9 9 9 9 9 9 9 9 9 9 9 9 9 9 9 9 9 9 1 0 1 0 1 0 1 0 1 0 1 0 1 0 1 0
8 7 7 10 0 1 0 1 0 1 0 1 9 1 0 1 0 1 0 1 0 1 0 2 5 1 0 1 0 11 0 1 0 1 0 1 0 1 0 1 0 1 0 1 0 1 0 1 0 1 0 1 0 1 0 11 11 11 11 11 11 11 11 11 11 11 11 11 11 11 11 11 11 11 11 11 11 11 11 11 11 11 11 11 11 11 0 1 0 1 0 1 0 1 0 1 0 1 0 1 0 1
8 8 7 7 10 0 1 0 1 0 1 0 9 0 1 0 1 0 1 0 1 0 1 2 5 0 1 0 1 0 1 0 1 0 1 0 1 0 1 0 1 0 1 0 1 0 1 0 1 0 11 0 1 0 1 11 11 11 11 11 11 11 11 11 11 11 11 11 11 11 11 11 11 11 11 11 11 11 11 11 11 11 11 11 11 11 1 0 1 0 1 0 1 0 1 0 1 0 1 0 1 0
8 8 8 7 7 10 0 1 0 1 0 1 9 1 0 1 0 1 0 1 0 1 0 2 5 1 0 1 0 1 0 1 0 1 0 1 0 1 0 1 0 11 0 1 0 1 0 1 0 1 0 1 0 1 0 11 11 11 11 11 11 11 11 11 11 11 11 11 11 11 11 11 11 11 11 11 11 11 11 11 11 11 11 11 11 11 0 1 0 1 0 1 0 1 0 1 0 1 0 1 0 1
8 8 8 8 7 7 10 10 10 10 1 0 9 0 1 0 1 0 1 0 1 0 1 2 5 0 1 0 1 0 1 0 1 0 1 0 1 0 1 0 1 0 1 0 1 0 1 0 1 0 1 0 1 0 1 11 11 11 11 11 11 11 11 11 11 11 11 11 11 11 11 11 11 11 11 11 11 11 11 11 11 11 11 11 11 11 1 0 1 0 1 0 1 0 1 0 1 0 1 0 1 0
8 8 8 8 8 7 7 7 7 10 0 1 9 1 0 1 0 1 0 1 0 1 0 2 6 1 0 1 0 1 0 1 0 1 0 1 0 11 0 1 0 1 0 1 0 1 0 1 0 1 0 1 0 1 0 11 11 11 11 11 11 11 11 11 11 11 11 11 11 11 11 11 11 11 11 11 11 11 11 11 11 11 11 11 11 11 0 1 0 1 0 1 0 1 0 1 0 1 0 1 0 1
8 8 8 8 8 7 9 9 9 9 9 9 9 9 9 9 9 9 9 9 9 9 9 9 9 9 9 9 9 9 9 0 1 0 1 0 1 0 1 0 1 0 11 11 1 0 1 0 1 0 1 0 1 0 1 11 11 11 11 11 11 11 11 11 11 11 11 11 11 11 11 11 11 11 11 11 11 11 11 11 11 11 11 11 11 11 1 0 1 0 1 0 1 0 1 0 1 0 1 0 1 0
8 8 8 8 8 7 7 7 7 10 0 1 0 1 0 1 0 1 0 1 0 1 0 2 6 1 0 1 0 9 0 1 0 1 0 1 0 1 0 1 0 1 0 1 0 1 0 1 0 11 0 1 0 1 0 11 11 11 11 11 11 11 11 11 11 11 11 11 11 11 11 11 11 11 11 11 11 11 11 11 11 11 11 11 11 11 0 1 0 1 0 1 0 1 0 1 0 1 0 1 0 1
8 8 8 8 7 7 10 10 10 10 1 0 1 0 1 0 1 0 1 0 1 0 1 2 5 0 1 0 1 9 1 0 1 0 1 0 1 0 1 0 1 0 1 0 1 0 11 0 1 0 1 0 1 0 1 11 11 11 11 11 11 11 11 11 11 11 11 11 11 11 11 11 11 11 11 11 11 11 11 11 11 11 11 11 11 11 1 0 1 0 1 0 1 0 1 0 1 0 1 0 1 0
8 8 8 7 7 10 0 1 0 1 0 1 0 1 0 1 0 1 0 1 0 1 0 2 5 1 0 1 0 9 0 1 0 1 0 1 0 1 0 1 0 1 11 1 0 1 0 1 0 1 0 1 0 1 0 1 11 11 11 11 11 11 11 11 11 11 11 11 11 11 11 11 11 11 11 11 11 11 11 11 11 11 11 11 11 11 11 0 1 0 1 0 1 0 1 0 1 0 1 0 1 0
8 8 7 7 10 0 1 0 1 0 1 0 1 0 1 0 1 0 1 0 1 0 1 2 5 0 1 0 1 9 1 0 1 0 1 0 1 0 11 0 1 0 1 0 1 0 1 0 1 0 1 0 1 0 1 0 1 11 11 11 11 11 11 11 11 11 11 11 11 11 11 11 11 11 11 11 11 11 11 11 11 11 11 11 11 11 11 1 0 1 0 1 0 1 0 1 0 1 0 1 0 1
8 7 7 10 0 1 0 1 0 1 0 1 0 1 0 1 0 1 0 1 0 1 0 2 5 1 0 1 0 9 0 1 0 11 0 1 0 1 0 1 0 1 0 1 0 1 0 1 0 1 0 1 0 1 0 1 0 1 11 11 11 11 11 11 11 11 11 11 11 11 11 11 11 11 11 11 11 11 11 11 11 11 11 11 11 11 11 0 1 0 1 0 1 0 1 0 1 0 1 0 1 0
8 7 10 0 1 0 1 0 1 0 1 0 1 0 1 0 1 0 1 0 1 0 1 2 5 0 1 0 1 9 1 0 1 0 1 0 1 0 1 0 1 0 1 0 1 0 1 0 1 0 11 0 1 0 1 0 1 0 1 11 11 11 11 11 11 11 11 11 11 11 11 11 11 11 11 11 11 11 11 11 11 11 11 11 11 11 11 1 0 1 0 1 0 1 0 1 0 1 0 1 0 1
8 7 10 1 0 1 0 1 0 1 0 1 0 1 0 1 0 1 0 1 0 1 0 2 5 1 0 1 0 9 0 1 0 1 0 1 0 1 0 1 0 1 0 1 0 1 0 1 0 1 0 1 0 1 0 1 0 11 0 1 11 11 11 11 11 11 11 11 11 11 11 11 11 11 11 11 11 11 11 11 11 11 11 11 11 11 11 0 1 0 1 0 1 0 1 0 1 0 1 0 1 0
8 7 10 6 4 4 4 4 4 4 4 4 4 4 4 4 4 4 4 4 4 4 4 4 6 0 1 0 1 9 1 0 1 0 1 0 1 0 1 0 1 0 1 0 1 0 1 0 1 0 1 0 1 0 1 0 1 0 1 0 11 11 11 11 11 11 11 11 11 11 11 11 11 11 11 11 11 11 11 11 11 11 11 11 11 11 11 1 0 1 0 1 0 1 0 1 0 1 0 1 0 1 0
8 7 10 3 3 3 3 3 3 3 3 3 3 3 3 3 3 3 3 3 3 3 3 3 3 1 0 1 0 9 0 1 0 1 0 1 0 1 0 1 0 1 0 1 0 1 0 1 0 1 0 1 0 1 0 1 0 1 0 1 0 11 11 11 11 11 11 11 11 11 11 11 11 11 11 11 11 11 11 11 11 11 11 11 11 11 11 0 1 0 1 0 1 0 1 0 1 0 1 0 1 0
8 7 10 0 1 0 1 0 1 0 1 0 1 0 1 0 1 0 1 0 1 0 1 0 1 0 1 0 1 9 1 0 1 0 1 0 1 0 1 0 1 0 1 0 1 0 1 0 1 0 1 0 1 0 1 0 1 0 1 0 1 0 11 11 11 11 11 11 11 11 11 11 11 11 11 11 11 11 11 11 11 11 11 11 11 11 11 1 0 1 0 1 0 1 0 1 0 1 0 1 0 1
8 7 10 1 0 1 0 1 0 1 0 1 0 1 0 1 0 1 0 1 0 1 0 1 0 1 0 1 0 9 0 1 0 1 0 1 0 1 0 1 0 1 0 1 0 1 0 1 0 1 0 1 0 1 0 1 0 1 0 1 0 1 0 1 0 1 0 1 0 1 0 1 0 1 0 1 0 1 0 1 0 1 0 1 0 1 0 1 0 1 0 1 0 1 0 1 0 1 0 1
8 7 10 0 1 0 1 0 1 0 1 0 1 0 1 0 1 0 1 0 1 0 1 0 1 0 1 0 1 9 1 0 1 0 1 0 1 0 1 0 1 0 1 0 1 0 1 0 1 0 1 0 1 0 1 0 1 0 1 0 1 0 1 0 1 0 1 0 1 0 1 0 1 0 1 0 1 0 1 0 1 0 1 0 1 0 1 0 1 0 1 0 1 0 1 0 1 0 1 0
8 7 10 1 0 1 0 1 0 1 0 1 0 1 0 1 0 1 0 1 0 1 0 1 0 1 0 1 0 9 0 1 0 1 0 1 0 1 0 1 0 1 0 1 0 1 0 1 0 1 0 1 0 1 0 1 0 1 0 1 0 1 0 1 0 1 0 1 0 1 0 1 0 1 0 1 0 1 0 1 0 1 0 1 0 1 0 1 0 1 0 1 0 1 0 1 0 1 0 1
8 7 10 0 1 0 1 0 1 0 1 0 1 0 1 0 1 0 1 0 1 0 1 0 1 0 1 0 1 9 1 0 1 0 1 0 1 0 1 0 1 0 1 0 1 0 1 0 1 0 1 0 1 0 1 0 1 0 1 0 1 0 1 0 1 0 1 0 1 0 1 0 1 0 1 0 1 0 1 0 1 0 1 0 1 0 1 0 1 0 1 0 1 0 1 0 1 0 1 0
8 7 10 1 0 1 0 1 0 1 0 1 0 1 0 1 0 1 0 1 0 1 0 1 0 1 0 1 0 9 0 1 0 1 0 1 0 1 0 1 0 1 0 1 0 1 0 1 0 1 0 1 0 1 0 1 0 1 0 1 0 1 0 1 0 1 0 1 0 1 0 1 0 1 0 1 0 1 0 1 0 1 0 1 0 1 0 1 0 1 0 1 0 1 0 1 0 1 0 1
8 7 10 0 1 0 1 0 1 0 1 0 1 0 1 0 1 0 1 0 1 0 1 0 1 0 1 0 1 9 1 0 1 0 1 0 1 0 1 0 1 0 1 0 1 0 1 0 1 0 1 0 1 0 1 0 1 0 1 0 1 0 1 0 1 0 1 0 1 0 1 0 1 0 1 0 1 0 1 0 1 0 1 0 1 0 1 0 1 0 1 0 1 0 1 0 1 0 1 0
8 7 10 1 0 1 0 1 0 1 0 1 0 1 0 1 0 1 0 1 0 1 0 1 0 1 0 1 0 9 0 1 0 1 0 1 0 1 0 1 0 1 0 1 0 1 0 1 0 1 0 1 0 1 0 1 0 1 0 1 0 1 0 1 0 1 0 1 0 1 0 1 0 1 0 1 0 1 0 1 0 1 0 1 0 1 0 1 0 1 0 1 0 1 0 1 0 1 0 1
8 7 10 0 1 0 1 0 1 0 1 0 1 0 1 0 1 0 1 0 1 0 1 0 1 0 1 0 1 9 1 0 1 0 1 0 1 0 1 0 1 0 1 0 1 0 1 0 1 0 1 0 1 0 1 0 1 0 1 0 1 0 1 0 1 0 1 0 1 0 1 0 1 0 1 0 1 0 1 0 1 0 1 0 1 0 1 0 1 0 1 0 1 0 1 0 1 0 1 0
8 7 10 1 0 1 0 1 0 1 0 1 0 1 0 1 0 1 0 1 0 1 0 1 0 1 0 1 0 9 0 1 0 1 0 1 0 1 0 1 0 1 0 1 0 1 0 1 0 1 0 1 0 1 0 1 0 1 0 1 0 1 0 1 0 1 0 1 0 1 0 1 0 1 0 1 0 1 0 1 0 1 0 1 0 1 0 1 0 1 0 1 0 1 0 1 0 1 0 1
8 7 10 0 1 0 1 0 1 0 1 0 1 0 1 0 1 0 1 0 1 0 1 0 1 0 1 9 9 9 9 9 1 0 1 0 1 0 1 0 1 0 1 0 1 0 1 0 1 0 1 0 1 0 1 0 1 0 1 0 1 0 1 0 1 0 1 0 1 0 1 0 1 0 1 0 1 0 1 0 1 0 1 0 1 0 1 0 1 0 1 0 1 0 1 0 1 0 1 0
8 7 10 1 0 1 0 1 0 1 0 1 0 1 0 1 0 1 0 1 0 1 0 1 0 1 0 9 9 9 9 9 0 1 0 1 0 1 0 1 0 1 0 1 0 1 0 1 0 1 0 1 0 1 0 1 0 1 0 1 0 1 0 1 0 1 0 1 0 1 0 1 0 1 0 1 0 1 0 1 0 1 0 1 0 1 0 1 0 1 0 1 0 1 0 1 0 1 0 1
8 7 10 0 1 0 1 0 1 0 1 0 1 0 1 0 1 0 1 0 1 0 1 0 1 0 1 9 9 9 9 9 1 0 1 0 1 0 1 0 1 0 1 0 1 0 1 0 1 0 1 0 1 0 1 0 1 0 1 0 1 0 1 0 1 0 1 0 1 0 1 0 1 0 1 0 1 0 1 0 1 0 1 0 1 0 1 0 1 0 1 0 1 0 1 0 1 0 1 0
8 7 10 1 0 1 0 1 0 1 0 1 0 1 0 1 0 1 0 1 0 1 0 1 0 1 0 1 0 1 0 1 0 1 0 1 0 1 0 1 0 1 0 1 0 1 0 1 0 1 0 1 0 1 0 1 0 1 0 1 0 1 0 1 0 1 0 1 0 1 0 1 0 1 0 1 0 1 0 1 0 1 0 1 0 1 0 1 0 1 0 1 0 1 0 1 0 1 0 1
8 7 10 0 1 0 1 0 1 0 1 0 1 0 1 0 1 0 1 0 1 0 1 0 1 0 1 0 1 0 1 0 1 0 1 0 1 0 1 0 1 0 1 0 1 0 1 0 1 0 1 0 1 0 1 0 1 0 1 0 1 0 1 0 1 0 1 0 1 0 1 0 1 0 1 0 1 0 1 0 1 0 1 0 1 0 1 0 1 0 1 0 1 0 1 0 1 0 1 0
8 7 10 1 0 1 0 1 0 1 0 1 0 1 0 1 0 1 0 1 0 1 0 1 0 1 0 1 0 1 0 1 0 1 0 1 0 1 0 1 0 1 0 1 0 1 0 1 0 1 0 1 0 1 0 1 0 1 0 1 0 1 0 1 0 1 0 1 0 1 0 1 0 1 0 1 0 1 0 1 0 1 0 1 0 1 0 1 0 1 0 1 0 1 0 1 0 1 0 1
8 7 10 0 1 0 1 0 1 0 1 0 1 0 1 0 1 0 1 0 1 0 1 0 1 0 1 0 1 0 1 0 1 0 1 0 1 0 1 0 1 0 1 0 1 0 1 0 1 0 1 0 1 0 1 0 1 0 1 0 1 0 1 0 1 0 1 0 1 0 1 0 1 0 1 0 1 0 1 0 1 0 1 0 1 0 1 0 1 0 1 0 1 0 1 0 1 0 1 0
8 7 10 1 0 1 0 1 0 1 0 1 0 1 0 1 0 1 0 1 0 1 0 1 0 1 0 1 0 1 0 1 0 1 0 1 0 1 0 1 0 1 0 1 0 1 0 1 0 1 0 1 0 1 0 1 0 1 0 1 0 1 0 1 0 1 0 1 0 1 0 1 0 1 0 1 0 1 0 1 0 1 0 1 0 1 0 1 0 1 0 1 0 1 0 1 0 1 0 1
8 7 10 0 1 0 1 0 1 0 1 0 1 0 1 0 1 0 1 0 1 0 1 0 1 0 1 0 1 0 1 0 1 0 1 0 1 0 1 0 1 0 1 0 1 0 1 0 1 0 1 0 1 0 1 0 1 0 1 0 1 0 1 0 1 0 1 0 1 0 1 0 1 0 1 0 1 0 1 0 1 0 1 0 1 0 1 0 1 0 1 0 1 0 1 0 1 0 1 0
8 7 10 1 0 1 0 1 0 1 0 1 0 1 0 1 0 1 0 1 0 1 0 1 0 1 0 1 0 1 0 1 0 1 0 1 0 1 0 1 0 1 0 1 0 1 0 1 0 1 0 1 0 1 0 1 0 1 0 1 0 1 0 1 0 1 0 1 0 1 0 1 0 1 0 1 0 1 0 1 0 1 0 1 0 1 0 1 0 1 0 1 0 1 0 1 0 1 0 1
8 7 10 0 1 0 1 0 1 0 1 0 1 0 1 0 1 0 1 0 1 0 1 0 1 0 1 0 1 0 1 0 1 0 1 0 1 0 1 0 1 0 1 0 1 0 1 0 1 0 1 0 1 0 1 0 1 0 1 0 1 0 1 0 1 0 1 0 1 0 1 0 1 0 1 0 1 0 1 0 1 0 1 0 1 0 1 0 1 0 1 0 1 0 1 0 1 0 1 0
8 7 10 1 0 1 0 1 0 1 0 1 0 1 0 1 0 1 0 1 0 1 0 1 0 1 0 1 0 1 0 1 0 1 0 1 0 1 0 1 0 1 0 1 0 1 0 1 0 1 0 1 0 1 0 1 0 1 0 1 0 1 0 1 0 1 0 1 0 1 0 1 0 1 0 1 0 1 0 1 0 1 0 1 0 1 0 1 0 1 0 1 0 1 0 1 0 1 0 1
8 7 10 0 1 0 1 0 1 0 1 0 1 0 1 0 1 0 1 0 1 0 1 0 1 0 1 0 1 0 1 0 1 0 1 0 1 0 1 0 1 0 1 0 1 0 1 0 1 0 1 0 1 0 1 0 1 0 1 0 1 0 1 0 1 0 1 0 1 0 1 0 1 0 1 0 1 0 1 0 1 0 1 0 1 0 1 0 1 0 1 0 1 0 1 0 1 0 1 0
8 7 10 1 0 1 0 1 0 1 0 1 0 1 0 1 0 1 0 1 0 1 0 1 0 1 0 1 0 1 0 1 0 1 0 1 0 1 0 1 0 1 0 1 0 1 0 1 0 1 0 1 0 1 0 1 0 1 0 1 0 1 0 1 0 1 0 1 0 1 0 1 0 1 0 1 0 1 0 1 0 1 0 1 0 1 0 1 0 1 0 1 0 1 0 1 0 1 0 1
8 7 10 0 1 0 1 0 1 0 1 0 1 0 1 0 1 0 1 0 1 0 1 0 1 0 1 0 1 0 1 0 1 0 1 0 1 0 1 0 1 0 1 0 1 0 1 0 1 0 1 0 1 0 1 0 1 0 1 0 1 0 1 0 1 0 1 0 1 0 1 0 1 0 1 0 1 0 1 0 1 0 1 0 1 0 1 0 1 0 1 0 1 0 1 0 1 0 1 0
8 7 10 1 0 1 0 1 0 1 0 1 0 1 0 1 0 1 0 1 0 1 0 1 0 1 0 1 0 1 0 1 0 1 0 1 0 1 0 1 0 1 0 1 0 1 0 1 0 1 0 1 0 1 0 1 0 1 0 1 0 1 0 1 0 1 0 1 0 1 0 1 0 1 0 1 0 1 0 1 0 1 0 1 0 1 0 1 0 1 0 1 0 1 0 1 0 1 0 1
8 7 10 0 1 0 1 0 1 0 1 0 1 0 1 0 1 0 1 0 1 0 1 0 1 0 1 0 1 0 1 0 1 0 1 0 1 0 1 0 1 0 1 0 1 0 1 0 1 0 1 0 1 0 1 0 1 0 1 0 1 0 1 0 1 0 1 0 1 0 1 0 1 0 1 0 1 0 1 0 1 0 1 0 1 0 1 0 1 0 1 0 1 0 1 0 1 0 1 0
8 7 10 1 0 1 0 1 0 1 0 1 0 1 0 1 0 1 0 1 0 1 0 1 0 1 0 1 0 1 0 1 0 1 0 1 0 1 0 1 0 1 0 1 0 1 0 1 0 1 0 1 0 1 0 1 0 1 0 1 0 1 0 1 0 1 0 1 0 1 0 1 0 1 0 1 0 1 0 1 0 1 0 1 0 1 0 1 0 1 0 1 0 1 0 1 0 1 0 1
8 7 10 0 1 0 1 0 1 0 1 0 1 0 1 0 1 0 1 0 1 0 1 0 1 0 1 0 1 0 1 0 1 0 1 0 1 0 1 0 1 0 1 0 1 0 1 0 1 0 1 0 1 0 1 0 1 0 1 0 1 0 1 0 1 0 1 0 1 0 1 0 1 0 1 0 1 0 1 0 1 0 1 0 1 0 1 0 1 0 1 0 1 0 1 0 1 0 1 0
8 7 10 1 0 1 0 1 0 1 0 1 0 1 0 1 0 1 0 1 0 1 0 1 0 1 0 1 0 1 0 1 0 1 0 1 0 1 0 1 0 1 0 1 0 1 0 1 0 1 0 1 0 1 0 1 0 1 0 1 0 1 0 1 0 1 0 1 0 1 0 1 0 1 0 1 0 1 0 1 0 1 0 1 0 1 0 1 0 1 0 1 0 1 0 1 0 1 0 1
8 7 10 0 1 0 1 0 1 0 1 0 1 0 1 0 1 0 1 0 1 0 1 0 1 0 1 0 1 0 1 0 1 0 1 0 1 0 1 0 1 0 1 0 1 0 1 0 1 0 1 0 1 0 1 0 1 0 1 0 1 0 1 0 1 0 1 0 1 0 1 0 1 0 1 0 1 0 1 0 1 0 1 0 1 0 1 0 1 0 1 0 1 0 1 0 1 0 1 0
8 7 10 1 0 1 0 1 0 1 0 1 0 1 0 1 0 1 0 1 0 1 0 1 0 1 0 1 0 1 0 1 0 1 0 1 0 1 0 1 0 1 0 1 0 1 0 1 0 1 0 1 0 1 0 1 0 1 0 1 0 1 0 1 0 1 0 1 0 1 0 1 0 1 0 1 0 1 0 1 0 1 0 1 0 1 0 1 0 1 0 1 0 1 0 1 0 1 0 1
8 7 10 0 1 0 1 0 1 0 1 0 1 0 1 0 1 0 1 0 1 0 1 0 1 0 1 0 1 0 1 0 1 0 1 0 1 0 1 0 1 0 1 0 1 0 1 0 1 0 1 0 1 0 1 0 1 0 1 0 1 0 1 0 1 0 1 0 1 0 1 0 1 0 1 0 1 0 1 0 1 0 1 0 1 0 1 0 1 0 1 0 1 0 1 0 1 0 1 0
8 7 10 1 0 1 0 1 0 1 0 1 0 1 0 1 0 1 0 1 0 1 0 1 0 1 0 1 0 1 0 1 0 1 0 1 0 1 0 1 0 1 0 1 0 1 0 1 0 1 0 1 0 1 0 1 0 1 0 1 0 1 0 1 0 1 0 1 0 1 0 1 0 1 0 1 0 1 0 1 0 1 0 1 0 1 0 1 0 1 0 1 0 1 0 1 0 1 0 1
8 7 10 0 1 0 1 0 1 0 1 0 1 0 1 0 1 0 1 0 1 0 1 0 1 0 1 0 1 0 1 0 1 0 1 0 1 0 1 0 1 0 1 0 1 0 1 0 1 0 1 0 1 0 1 0 1 0 1 0 1 0 1 0 1 0 1 0 1 0 1 0 1 0 1 0 1 0 1 0 1 0 1 0 1 0 1 0 1 0 1 0 1 0 1 0 1 0 1 0
8 7 10 1 0 1 0 1 0 1 0 1 0 1 0 1 0 1 0 1 0 1 0 1 0 1 0 1 0 1 0 1 0 1 0 1 0 1 0 1 0 1 0 1 0 1 0 1 0 1 0 1 0 1 0 1 0 1 0 1 0 1 0 1 0 1 0 1 0 1 0 1 0 1 0 1 0 1 0 1 0 1 0 1 0 1 0 1 0 1 0 1 0 1 0 1 0 1 0 1
8 7 10 0 1 0 1 0 1 0 1 0 1 0 1 0 1 0 1 0 1 0 1 0 1 0 1 0 1 0 1 0 1 0 1 0 1 0 1 0 1 0 1 0 1 0 1 0 1 0 1 0 1 0 1 0 1 0 1 0 1 0 1 0 1 0 1 0 1 0 1 0 1 0 1 0 1 0 1 0 1 0 1 0 1 0 1 0 1 0 1 0 1 0 1 0 1 0 1 0
8 7 10 1 0 1 0 1 0 1 0 1 0 1 0 1 0 1 0 1 0 1 0 1 0 1 0 1 0 1 0 1 0 1 0 1 0 1 0 1 0 1 0 1 0 1 0 1 0 1 0 1 0 1 0 1 0 1 0 1 0 1 0 1 0 1 0 1 0 1 0 1 0 1 0 1 0 1 0 1 0 1 0 1 0 1 0 1 0 1 0 1 0 1 0 1 0 1 0 1
8 7 10 10 10 10 10 10 10 10 10 10 10 10 10 10 10 10 10 10 10 10 10 10 10 10 10 10 10 10 10 10 10 10 10 10 10 10 10 10 10 10 10 10 10 10 10 10 10 10 10 10 10 10 10 10 10 10 10 10 10 10 10 10 10 10 10 10 10 10 10 10 10 10 10 10 10 10 10 10 10 10 10 10 10 10 10 10 10 10 10 10 10 10 10 10 10 10 10 10
8 7 7 7 7 7 7 7 7 7 7 7 7 7 7 7 7 7 7 7 7 7 7 7 7 7 7 7 7 7 7 7 7 7 7 7 7 7 7 7 7 7 7 7 7 7 7 7 7 7 7 7 7 7 7 7 7 7 7 7 7 7 7 7 7 7 7 7 7 7 7 7 7 7 7 7 7 7 7 7 7 7 7 7 7 7 7 7 7 7 7 7 7 7 7 7 7 7 7 7
8 8 8 8 8 8 8 8 8 8 8 8 8 8 8 8 8 8 8 8 8 8 8 8 8 8 8 8 8 8 8 8 8 8 8 8 8 8 8 8 8 8 8 8 8 8 8 8 8 8 8 8 8 8 8 8 8 8 8 8 8 8 8 8 8 8 8 8 8 8 8 8 8 8 8 8 8 8 8 8 8 8 8 8 8 8 8 8 8 8 8 8 8 8 8 8 8 8 8 8